P1Information_sheet_and_consent_anu_hin_target_001CONSENTSHEET	सूचित सहमति	sUciwa sahamawi	INFORMED CONSENT 
P1Information_sheet_and_consent_anu_hin_target_002ADDRESS	क्रिश्चियन मेडिकल कॉलेज, वेल्लोर डिपार्टमेंट ऑफ यूरोलॉजी	kriSciyana medikala koYleja , vellora dipArtameMta oYPa yUroloYjI 	Christian Medical College, Vellore Department of Urology.
P1Information_sheet_and_consent_anu_hin_target_003TITLE	मूत्राशय ट्यूमर के पोस्ट-ट्रांसयूरिथ्रल विच्छेदन (टीयूआरबीटी) के बाद 3 महीने में पुनरावृत्ति होने वाले कैंसर में निम्न दो स्थितियों की तुलना करने वाला एक यादृच्छिक नियंत्रित परीक्षण (आरसीटी): 3 सेमी या इससे कम आकार और संख्या में 3 या इससे कम मूत्राशय ट्यूमर्स के लिए अनिरंतर पानी की धार से  मूत्राशय की सफाई ( इरिगेशन) करना बनाम निरंतर पानी की धार से मूत्राशय की सफाई करना।	mUwrASaya tyUmara ke posta-trAMsayUriWrala vicCexana ( tIyUArabItI ) ke bAxa 3 mahIne meM punarAvqwwi hone vAle kEMsara meM nimna xo sWiwiyoM kI wulanA karane vAlA eka yAxqcCika niyaMwriwa parIkRaNa ( ArasItI ) : 3 semI yA isase kama AkAra Ora saMKyA meM 3 yA isase kama mUwrASaya tyUmarsa ke lie aniraMwara pAnI kI XAra se mUwrASaya kI saPAI ( irigeSana ) karanA banAma niraMwara pAnI kI XAra se mUwrASaya kI saPAI karanA .	 A Randomized controlled trial (RCT) comparing post-transurethral resection of bladder tumor (TURBT) recurrence at 3 months: Non continuous bladder irrigation vs.continuous bladder irrigation for bladder tumours ≤3 cm in size and ≤3 in numbers.
P1Information_sheet_and_consent_anu_hin_target_004INFOSHEET	सूचना पत्रक 	sUcanA pawraka	Information sheet.
P1Information_sheet_and_consent_anu_hin_target_005	"हम आपको मूत्राशय ट्यूमर ( टीयूआरबीटी ) के ट्रांसयूरिथ्रल रिसेक्शन के बाद आकार में 3 सेमी या इससे कम और संख्या में 3 या इससे कम एकल मूत्राशय ट्यूमर के उपचार के रूप में कंटीन्यूएस ब्लैडर इरिगेशन ( सीबीआई ) और पानी की धार से सफाई नहीं करने ( नॉन - इरिगेशन ) की तुलना करने वाले एक अध्ययन में भाग लेने के लिए आमंत्रित करते हैं ।"	hama Apako mUwrASaya tyUmara ( tIyUArabItI ) ke trAMsayUriWrala risekSana ke bAxa AkAra meM 3 semI yA isase kama Ora saMKyA meM 3 yA isase kama ekala mUwrASaya tyUmara ke upacAra ke rUpa meM kaMtInyUesa blEdara irigeSana ( sIbIAI ) Ora pAnI kI XAra se saPAI nahIM karane ( noYna - irigeSana ) kI wulanA karane vAle eka aXyayana meM BAga lene ke lie AmaMwriwa karawe hEM .	We invite you to take part in a study comparing continuous bladder irrigation (CBI) and non-irrigation as treatments for solitary bladder tumours ≤3 cm in size and ≤ 3 in numbers after transurethral resection of bladder tumour (TURBT).
P1Information_sheet_and_consent_anu_hin_target_006a	इनमें से अधिकांश ट्यूमर कम जोखिम भरे होते हैं ।	inameM se aXikAMSa tyUmara kama joKima Bare howe hEM .	Most of these tumours are less severe types. 
P1Information_sheet_and_consent_anu_hin_target_006b	जो मूत्राशय में गहराई तक नहीं फैलते हैं ।	jo mUwrASaya meM gaharAI waka nahIM PElawe hEM .	that don't deeply spread into the bladder. 
P1Information_sheet_and_consent_anu_hin_target_006c	और जो आमतौर पर घातक नहीं होते हैं।	Ora jo AmawOra para GAwaka nahIM howe hEM .	and these are usually not deadly.
P1Information_sheet_and_consent_anu_hin_target_007a	हालांकि , वे बार-बार होते हैं ।	hAlAMki , ve bAra - bAra howe hEM .	However, they tend to recur.
P1Information_sheet_and_consent_anu_hin_target_007b	अतः नियमित जांच करने और ट्यूमर हटाने के लिये उपचार की आवश्यकता होती है।	awaH niyamiwa jAMca karane Ora tyUmara hatAne ke liye upacAra kI AvaSyakawA howI hEn.	 requiring regular check-ups and tumour removal treatments.
P1Information_sheet_and_consent_anu_hin_target_008a	ट्यूमर हटाने के बाद , रक्तस्राव होना आम बात है ।	tyUmara hatAne ke bAxa , rakwasrAva honA Ama bAwa hE .	After tumour removal, bleeding is common.
P1Information_sheet_and_consent_anu_hin_target_008b	 और हम आमतौर पर मूत्राशय को लगातार फ्लश करने के लिए एक ट्यूब लगा कर इसका प्रबंधन करते हैं।	Ora hama AmawOra para mUwrASaya ko lagAwAra PlaSa karane ke lie eka tyUba lagA kara isakA prabaMXana karawe hEM .	And we usually manage it by placing a tube to continuously flush the bladder.
P1Information_sheet_and_consent_anu_hin_target_009a	प्राथमिक लक्ष्य रक्त को साफ करना और थक्के बनने को रोकना है ।	prAWamika lakRya rakwa ko sAPa karanA Ora Wakke banane ko rokanA hE .	The primary goal is to clear out blood and prevent clots.
P1Information_sheet_and_consent_anu_hin_target_009b	 लेकिन यह किसी भी शेष रही कैंसर कोशिकाओं को फ्लश कर के कैंसर की पुनरावृत्ति को रोकने में भी मदद कर सकता है।	lekina yaha kisI BI SeRa rahI kEMsara koSikAoM ko PlaSa kara ke kEMsara kI punarAvqwwi ko rokane meM BI maxaxa kara sakawA hE .	 But it might also help prevent cancer recurrence by washing out any remaining cancer cells.
P1Information_sheet_and_consent_anu_hin_target_010a	2016 में एक तुलना में यह पाया गया।	2016 meM eka wulanA meM yaha pAyA gayA .	A comparison in 2016 found. 
P1Information_sheet_and_consent_anu_hin_target_010b	कि मूत्राशय को फ्लश करने से कैंसर की आवृति का जोखिम 21% कम हो जाता है।	ki mUwrASaya ko PlaSa karane se kEMsara kI Avqwi kA joKima 21 % kama ho jAwA hE .	That flushing the bladder was associated with a 21% lower risk of cancer returning.
P1Information_sheet_and_consent_anu_hin_target_011a	जबकि अन्य अध्ययनों ने इस फ्लशिंग विधि की छान - बीन की है।	jabaki anya aXyayanoM ne isa PlaSiMga viXi kI CAna-bIna kI hE .	While other studies have explored this flushing method.
P1Information_sheet_and_consent_anu_hin_target_011b	कुछ समीक्षाओं ने पूर्वव्यापी डेटा और गैर - यादृच्छिक उपचारों के कारण चिंता जताई।	kuCa samIkRAoM ne pUrvavyApI detA Ora gEra-yAxqcCika upacAroM ke kAraNa ciMwA jawAI .	Some reviews raised concerns due to retrospective data and non-randomized treatments.
P1Information_sheet_and_consent_anu_hin_target_011c	 इससे उनके साक्ष्य कम विश्वसनीय हो गए।	isase unake sAkRya kama viSvasanIya ho gae .	making their evidence less reliable.
P1Information_sheet_and_consent_anu_hin_target_012a	हमारे नए अध्ययन में , हमारा उद्देश्य यह निर्धारित करना है।	hamAre nae aXyayana meM , hamArA uxxeSya yaha nirXAriwa karanA hE .	In our new study, we aim to determine. 
P1Information_sheet_and_consent_anu_hin_target_012b	कि क्या सेलाइन के साथ मूत्राशय को लगातार फ्लश करने से 3 महीने के भीतर पोस्टऑपरेटिव मूत्राशय ट्यूमर की पुनरावृत्ति और प्रतिकूल घटनाओं का होना प्रभावित होगा।	ki kyA selAina ke sAWa mUwrASaya ko lagAwAra PlaSa karane se 3 mahIne ke BIwara postaoYparetiva mUwrASaya tyUmara kI punarAvqwwi Ora prawikUla GatanAoM kA honA praBAviwa hogA .	Whether omitting continuous flushing of the bladder with saline will affect postoperative bladder tumour recurrence at 3 months and the occurrence of adverse events.
P1Information_sheet_and_consent_anu_hin_target_013	हम 3 सेमी या उससे छोटे ट्यूमर्स से पीडित 190 मूत्राशय कैंसर रोगियों को शामिल करना चाहते हैं।	hama 3 semI yA usase Cote tyUmarsa se pIdiwa 190 mUwrASaya kEMsara rogiyoM ko SAmila karanA cAhawe hEM .	We are seeking to include 190 bladder cancer patients diagnosed with tumours of 3 cm or smaller.
P1Information_sheet_and_consent_anu_hin_target_014	आपकी भागीदारी इस शोध में मूल्यवान अंतःदृष्टि का योगदान देगी।	ApakI BAgIxArI isa SoXa meM mUlyavAna aMwaHxqRti kA yogaxAna xegI .	Your participation will contribute valuable insights to this research.
P1Information_sheet_and_consent_anu_hin_target_015	इस अध्ययन से सभी को क्या लाभ होगा?	isa aXyayana se saBI ko kyA lABa hogA?	"How is this study going to benefit everyone?"
P1Information_sheet_and_consent_anu_hin_target_016	कंटीन्यूएस ब्लैडर इरिगेशन ( सीबीआई ) रोगियों के लिए काफी असुविधाजनक हो सकती है।	kaMtInyUesa blEdara irigeSana ( sIbIAI ) rogiyoM ke lie kAPI asuviXAjanaka ho sakawI hE .	Continuous bladder irrigation (CBI) can be quite inconvenient for patients.
P1Information_sheet_and_consent_anu_hin_target_017a	हालांकि , अगर हमारे अध्ययन से पता यह चलता है।	hAlAMki , agara hamAre aXyayana se pawA yaha calawA hE .	However, if our study reveals.
P1Information_sheet_and_consent_anu_hin_target_017b	कि इस आकार के ट्यूमर के इलाज के लिए यह आवश्यक नहीं है ।	ki isa AkAra ke tyUmara ke ilAja ke lie yaha AvaSyaka nahIM hE .	That it's not essential for treating tumors of this size.
P1Information_sheet_and_consent_anu_hin_target_017c	 तो इसका मतलब है।	wo isakA mawalaba hE .	 it means.
P1Information_sheet_and_consent_anu_hin_target_017d	कि प्रतिभागियों को अधिक सीधा और आरामदायक अनुभव हो सकता है।	ki prawiBAgiyoM ko aXika sIXA Ora ArAmaxAyaka anuBava ho sakawA hE .	 Participants might have a more straightforward and comfortable experience.
P1Information_sheet_and_consent_anu_hin_target_018a	हमें यह पता लगाना है।	hameM yaha pawA lagAnA hE.	Discovering that. 
P1Information_sheet_and_consent_anu_hin_target_018b	कि हम बिना किसी समस्या के सीबीआई का उपयोग करना छोड सकते हैं ।	ki hama binA kisI samasyA ke sIbIAI kA upayoga karanA Coda sakawe hEM .	we can skip using CBI without any issues.
P1Information_sheet_and_consent_anu_hin_target_018c	जो न केवल रोगियों के लिए चीजों को आसान बना सकता है ।	jo na kevala rogiyoM ke lie cIjoM ko AsAna banA sakawA hE .	Which could not only make things easier for patients. 
P1Information_sheet_and_consent_anu_hin_target_018d	बल्कि जो लागत में कमी और चिकित्सा संसाधनों का अधिक कुशल उपयोग करने में सहायक भी हो सकता है।	balki jo lAgawa meM kamI Ora cikiwsA saMsAXanoM kA aXika kuSala upayoga karane meM sahAyaka BI ho sakawA hE .	But also lead to cost savings and the more efficient use of medical resources.
P1Information_sheet_and_consent_anu_hin_target_019	इस अध्ययन में आपकी भागीदारी उपचार प्रक्रिया को बेहतर और रोगी के लिये अधिक अनुकूल बनाने में योगदान कर सकती है।	isa aXyayana meM ApakI BAgIxArI upacAra prakriyA ko behawara Ora rogI ke liye aXika anukUla banAne meM yogaxAna kara sakawI hE .	Your involvement in the study could contribute to making the treatment process better and more patient-friendly.
P1Information_sheet_and_consent_anu_hin_target_020a	यदि आप इस अध्ययन में भाग लेते हैं ।	yaxi Apa isa aXyayana meM BAga lewe hEM .	If you take part in this study. 
P1Information_sheet_and_consent_anu_hin_target_020b	तो आपको क्या करना होगा?	wo Apako kyA karanA hogA?	what will you have to do?
P1Information_sheet_and_consent_anu_hin_target_021a	यदि आप इस अध्ययन में भाग लेना चाहते हैं।	yaxi Apa isa aXyayana meM BAga lenA cAhawe hEM .	If you choose to participate in this study.
P1Information_sheet_and_consent_anu_hin_target_021b	तो आप यह पुष्टि करने के लिए एक मूल्यांकन से गुजरेंगे।	wo Apa yaha puRti karane ke lie eka mUlyAMkana se gujareMge .	You will undergo an assessment to confirm 
P1Information_sheet_and_consent_anu_hin_target_021c	कि आप अध्ययन के मानदंडों को पूरा करते हैं ।	ki Apa aXyayana ke mAnaxaMdoM ko pUrA karawe hEM .	That you meet the criteria for the study.
P1Information_sheet_and_consent_anu_hin_target_021d	 विशेष रूप से आकार में 3 सेमी या इससे कम और संख्या में 3 या इससे कम का मूत्राशय ट्यूमर होना।	viSeRa rUpa se AkAra meM 3 semI yA isase kama Ora saMKyA meM 3 yA isase kama kA mUwrASaya tyUmara honA .	Particularly having a bladder tumor of ≤3 cm in size and ≤ 3 in numbers.
P1Information_sheet_and_consent_anu_hin_target_022a	प्रतिभागियों को यादृच्छिक रूप से या तो कंटीन्यूएस ब्लैडर इरिगेशन ( सीबीआई ) समूह या पानी की धार से सफाई नहीं करने वाले समूह में रखा जाएगा।	prawiBAgiyoM ko yAxqcCika rUpa se yA wo kaMtInyUesa blEdara irigeSana ( sIbIAI ) samUha yA pAnI kI XAra se saPAI nahIM karane vAle samUha  meM raKA jAegA .	Participants will be randomly assigned to either the continuous bladder irrigation (CBI) group  or the non-irrigation group. 
P1Information_sheet_and_consent_anu_hin_target_022bF	पानी की धार से सफाई के बाद 1 घंटे के लिए 1 लीटर और उसके बाद अगले 2 घंटे के लिए 500 मिलीलीटर फिर अगले दिन सुबह 6 बजे तक 250 - 500 मिलीलीटर	 pAnI kI XAra se saPAI ke bAxa 1 GaMte ke lie 1 lItara Ora usake bAxa agale 2 GaMte ke lie 500 milIlItara Pira agale xina subaha 6 baje waka 250 - 500 milIlItara	Irrigation postoperatively 1 liter for 1 hour followed by 500 ml for subsequent 2 hours, then 250-500 ml till next day morning 6 Am.
P1Information_sheet_and_consent_anu_hin_target_022cF	सक्रिय रूप से पानी की धार से सफाई नहीं होगी ।	sakriya rUpa se pAnI kI XAra se saPAI nahIM hogI.	Won’t receive any irrigation postoperatively.
P1Information_sheet_and_consent_anu_hin_target_023	किसी भी आवर्ती ट्यूमर की जांच और आकलन के लिए नियमित अनुवर्ती अपॉइंटमेंट निर्धारित किये जाएंगे।	kisI BI AvarwI tyUmara kI jAMca Ora Akalana ke lie niyamiwa anuvarwI apoYiMtameMta nirXAriwa kiye jAeMge .	Regular follow-up appointments will be scheduled for routine check-ups and assessments of any recurring tumors.
P1Information_sheet_and_consent_anu_hin_target_024a	आपको अपने अनुभव और उपचार से संबंधित किसी भी असुविधा या परेशानी को साझा करने के लिए कहा जा सकता है ,।	Apako apane anuBava Ora upacAra se saMbaMXiwa kisI BI asuviXA yA pareSAnI ko sAJA karane ke lie kahA jA sakawA hE , .	You may be asked to share your experience and any discomfort or inconvenience related to the treatment.
P1Information_sheet_and_consent_anu_hin_target_024b	खासकर यदि आप सीबीआई समूह में हैं।	KAsakara yaxi Apa sIbIAI samUha meM hEM .	Especially if you are in the CBI group.
P1Information_sheet_and_consent_anu_hin_target_025	निर्धारित उपचार योजना का पालन करना और निर्धारित अपॉइंटमेंट्स में भाग लेना महत्वपूर्ण है।	nirXAriwa upacAra yojanA kA pAlana karanA Ora nirXAriwa apoYiMtameMtsa meM BAga lenA mahawvapUrNa hE .	It's important to adhere to the assigned treatment plan and attend scheduled appointments.
P1Information_sheet_and_consent_anu_hin_target_026a	इस अध्ययन में आपकी भागीदारी हमें यह समझने में मदद करने के लिए महत्वपूर्ण है।	isa aXyayana meM ApakI BAgIxArI hameM yaha samaJane meM maxaxa karane ke lie mahawvapUrNa hE .	Your participation in this study is vital in helping us understand. 
P1Information_sheet_and_consent_anu_hin_target_026b	कि क्या इस आकार के ट्यूमर के इलाज के लिए मूत्राशय का कंटीन्यूएस ब्लैडर इरिगेशन आवश्यक है।	ki kyA isa AkAra ke tyUmara ke ilAja ke lie mUwrASaya kA kaMtInyUesa blEdara irigeSana AvaSyaka hE .	Whether continuous bladder irrigation is necessary for treating tumors of this size.
P1Information_sheet_and_consent_anu_hin_target_027a	यदि आपको  अध्ययन से यह पता चलता है।	yaxi Apako aXyayana se yaha pawA calawA hE .	If the study suggests.
P1Information_sheet_and_consent_anu_hin_target_027b	कि सीबीआई आवश्यक नहीं है ।	ki sIbIAI AvaSyaka nahIM hE .	 that CBI may not be essential.
P1Information_sheet_and_consent_anu_hin_target_027c	तो इससे चिकित्सा क्षेत्र में रोगी-अनुकूल दृष्टिकोण में वृद्धि और संसाधनों में बचत हो सकती है।	wo isase cikiwsA kRewra meM rogI-anukUla xqRtikoNa meM vqxXi Ora saMsAXanoM meM bacawa ho sakawI hE .	It could lead to more patient-friendly approaches and resource savings in the medical field.
P1Information_sheet_and_consent_anu_hin_target_028	क्या इस अध्ययन के लिये मुझे अतिरिक्त खर्च करना पडेगा?	kyA isa aXyayana ke liye muJe awirikwa Karca karanA padegA?	Will this study cost me anything extra?
P1Information_sheet_and_consent_anu_hin_target_029	नहीं , इस अध्ययन के अंतर्गत आपको उपचार पर कोई अतिरिक्त लागत नहीं आएगी।	nahIM , isa aXyayana ke aMwargawa Apako upacAra para koI awirikwa lAgawa nahIM AegI .	No, you will not face any extra cost of treatment under this study.
P1Information_sheet_and_consent_anu_hin_target_030	क्या आप इस अध्ययन के शुरू होने के बाद इससे हट सकते हैं?	kyA Apa isa aXyayana ke SurU hone ke bAxa isase hata sakawe hEM?	Can you withdraw from this study after it starts?
P1Information_sheet_and_consent_anu_hin_target_031a	इस अध्ययन में आपकी भागीदारी पूरी तरह से स्वैच्छिक है ।	isa aXyayana meM ApakI BAgIxArI pUrI waraha se svEcCika hE .	Your participation in this study is entirely voluntary. 
P1Information_sheet_and_consent_anu_hin_target_031b	और आप इस अध्ययन में भाग लेने की अनुमति वापस लेने का निर्णय लेने के लिए भी स्वतंत्र हैं।	Ora Apa isa aXyayana meM BAga lene kI anumawi vApasa lene kA nirNaya lene ke lie BI svawaMwra hEM .	And you are also free to decide to withdraw permission to participate in this study.
P1Information_sheet_and_consent_anu_hin_target_032a	यदि आप ऐसा करते हैं।	yaxi Apa EsA karawe hEM .	If you do so.
P1Information_sheet_and_consent_anu_hin_target_032b	तो इससे इस अस्पताल में आपके सामान्य उपचार पर किसी भी तरह से कोई असर नहीं पडेगा।	wo isase isa aspawAla meM Apake sAmAnya upacAra para kisI BI waraha se koI asara nahIM padegA .	This will not affect your usual treatment at this hospital in any way.
P1Information_sheet_and_consent_anu_hin_target_033	अध्ययन समाप्त होने के बाद क्या होगा?	aXyayana samApwa hone ke bAxa kyA hogA?	What happens after the study is over?
P1Information_sheet_and_consent_anu_hin_target_034a	यदि आपको  अध्ययन से यह पता चलता है।	yaxi Apako aXyayana se pawA yaha calawA hE .	If the study indicates. 
P1Information_sheet_and_consent_anu_hin_target_034b	कि इस आकार के ट्यूमर के इलाज के लिए सीबीआई आवश्यक नहीं है ।	ki isa AkAra ke tyUmara ke ilAja ke lie sIbIAI AvaSyaka nahIM hE .	That CBI is not necessary for treating tumors of this size.
P1Information_sheet_and_consent_anu_hin_target_034c	तो यह चिकित्सा पद्धति के दिशा-निर्देशों को प्रभावित कर सकता है।	wo yaha cikiwsA paxXawi ke xiSA-nirxeSoM ko praBAviwa kara sakawA hE .	It could influence medical practice guidelines.
P1Information_sheet_and_consent_anu_hin_target_035	डॉक्टर वैकल्पिक , अधिक रोगी-अनुकूल दृष्टिकोणों पर विचार कर सकते हैं।	doYktara vEkalpika , aXika rogI-anukUla xqRtikoNoM para vicAra kara sakawe hEM .	Doctors may consider alternative, more patient-friendly approaches.
P1Information_sheet_and_consent_anu_hin_target_036	प्रतिभागियों को भविष्य में अधिक आरामदायक उपचार विकल्पों का अनुभव हो सकता है।	prawiBAgiyoM ko BaviRya meM aXika ArAmaxAyaka upacAra vikalpoM kA anuBava ho sakawA hE .	Participants may experience more comfortable treatment options in the future.
P1Information_sheet_and_consent_anu_hin_target_037a	इससे रोगी के अनुभवों में सुधार हो सकता है ।	isase rogI ke anuBavoM meM suXAra ho sakawA hE .	This can lead to improved patient experiences.
P1Information_sheet_and_consent_anu_hin_target_037b	और संभावित रूप से चिकित्सा लागत कम हो सकती है।	Ora saMBAviwa rUpa se cikiwsA lAgawa kama ho sakawI hE .	 And potentially reduced medical costs.
P1Information_sheet_and_consent_anu_hin_target_038	संक्षेप में , अध्ययन के अंत में , आकार में 3 सेमी या इससे कम और संख्या में 3 या इससे कम के मूत्राशय ट्यूमर के इलाज के लिए रोगी-अनुकूल दृष्टिकोण प्राप्त हो सकता है।	saMkRepa meM , aXyayana ke aMwa meM , AkAra meM 3 semI yA isase kama Ora saMKyA meM 3 yA isase kama ke mUwrASaya tyUmara ke ilAja ke lie rogI-anukUla xqRtikoNa prApwa ho sakawA hE .	In essence, the end of the study provides patient-friendly approaches to treating bladder tumors of ≤3 cm in size and ≤ 3 in numbers.
P1Information_sheet_and_consent_anu_hin_target_039	क्या आपकी व्यक्तिगत जानकारी गोपनीय रखी जाएगी?	kyA ApakI vyakwigawa jAnakArI gopanIya raKI jAegI?	Will your personal details be kept confidential?
P1Information_sheet_and_consent_anu_hin_target_040a	इस अध्ययन के परिणाम किसी मेडिकल जर्नल में प्रकाशित हो सकते हैं।	isa aXyayana ke pariNAma kisI medikala jarnala meM prakASiwa ho sakawe hEM .	The results of this study may be published in a medical journal. 
P1Information_sheet_and_consent_anu_hin_target_040b	लेकिन परिणामों के किसी भी प्रकाशन या प्रस्तुति में आपका नाम नहीं बताया जाएगा।	lekina pariNAmoM ke kisI BI prakASana yA praswuwi meM ApakA nAma nahIM bawAyA jAegA .	But you will not be identified by name in any publication or presentation of results.
P1Information_sheet_and_consent_anu_hin_target_041a	हालाँकि , यदि आप इस अध्ययन में भाग लेने का निर्णय लेते हैं।	hAlAzki , yaxi Apa isa aXyayana meM BAga lene kA nirNaya lewe hEM .	 However, should you decide to participate in this study. 
P1Information_sheet_and_consent_anu_hin_target_041b	तो आपके मेडिकल नोट्स की समीक्षा अध्ययन से जुडे लोगों द्वारा आपकी अतिरिक्त अनुमति के बिना की जा सकती है।	wo Apake medikala notsa kI samIkRA aXyayana se jude logoM xvArA ApakI awirikwa anumawi ke binA kI jA sakawI hE .	Your medical notes may be reviewed by people associated with the study without your additional permission.