Ecommerce_FAQ_001a	खाता बनाने/खोलने के लिए, हमारी वेबसाइट की ऊपरी दाएँ कोने पर 'साइन अप' बटन पर क्लिक करें ।	KAwA banAne/Kolane ke lie, hamArI vebasAita kI UparI xAez kone para 'sAina apa' batana para klika kareM .	To create/open an account, click on the 'Sign Up' button on the upper right corner of our website.
Ecommerce_FAQ_001b	और पंजीकरण प्रक्रिया को पूरी करने के लिए निर्देशों का पालन करें।	Ora paMjIkaraNa prakriyA ko pUrI karane ke lie nirxeSoM kA pAlana kareM.	And follow the instructions to complete the registration process.
Ecommerce_FAQ_002	हम ऑनलाइन ऑर्डर के लिए भुगतान विधियों के रूप में प्रमुख क्रेडिट कार्ड, डेबिट कार्ड और PayPal स्वीकार करते हैं।	hama OYnalAina OYrdara ke lie BugawAna viXiyoM ke rUpa meM pramuKa kredita kArda, debita kArda Ora _PayPal_ svIkAra karawe hEM.	We accept major credit cards, debit cards and PayPals as paid methods for online orders.
Ecommerce_FAQ_003	आप अपने खाते में लॉग इन करके और 'ऑर्डर इतिहास' अनुभाग पर जाकर अपने ऑर्डर को ट्रैक कर सकते हैं।	Apa apane KAwe meM lOYga ina karake Ora 'OYrdara iwihAsa' anuBAga para jAkara apane OYrdara ko trEka kara sakawe hEM.	You can track your order by logging into your account and going to the 'Order History' section.
Ecommerce_FAQ_004	वहाँ, आपको अपने शिपमेंट की ट्रैकिंग जानकारी मिलेगी।	vahAz, Apako apane SipameMta kI trEkiMga jAnakArI milegI.	There, you will get the tracking information of your shipment.
Ecommerce_FAQ_005a	हमारी वापसी नीति आपको पूर्ण धनवापसी के लिए खरीदारी के 30 दिनों के भीतर उत्पाद वापस करने की अनुमति देती है।	hamArI vApasI nIwi Apako pUrNa XanavApasI ke lie KarIxArI ke 30 xinoM ke BIwara uwpAxa vApasa karane kI anumawi xewI hE.	Our return policy allows you to return the product within 30 days of shopping for full correspondence.
Ecommerce_FAQ_005b	बशर्ते वे अपनी मूल स्थिति और पैकेजिंग में हों।	baSarwe ve apanI mUla sWiwi Ora pEkejiMga meM hoM.	Provided they are in their original position and packaging.
Ecommerce_FAQ_006	विस्तृत निर्देशों के लिए कृपया हमारे रिटर्न पेज को देखें।	viswqwa nirxeSoM ke lie kqpayA hamAre ritarna peja ko xeKeM.	For detailed instructions, please see our return page.
Ecommerce_FAQ_007a	आपका ऑर्डर अभी तक शिप नहीं हुआ है ।	ApakA OYrdara aBI waka Sipa nahIM huA hE .	Your order has not been shipped yet.
Ecommerce_FAQ_007b	तो आप अपना ऑर्डर रद्द कर सकते हैं।	wo Apa apanA OYrdara raxxa kara sakawe hEM.	So you can cancel your order.
Ecommerce_FAQ_008a	कृपया अपने ऑर्डर विवरण के साथ हमारी ग्राहक सहायता टीम से संपर्क करें।	kqpayA apane OYrdara vivaraNa ke sAWa hamArI grAhaka sahAyawA tIma se saMparka kareM.	Please contact our customer aid team with your order details.
Ecommerce_FAQ_008b	और हम रद्दीकरण प्रक्रिया में आपकी सहायता करेंगे।	Ora hama raxxIkaraNa prakriyA meM ApakI sahAyawA kareMge.	And we will help you in the cancellation process.
Ecommerce_FAQ_009	शिपिंग का समय गंतव्य और चुनी गई शिपिंग विधि के आधार पर अलग-अलग होता है।	SipiMga kA samaya gaMwavya Ora cunI gaI SipiMga viXi ke AXAra para alaga-alaga howA hE.	Shipping time varies depending on the destination and selected shipping method.
Ecommerce_FAQ_010a	मानक शिपिंग में आमतौर पर 3-5 व्यावसायिक दिन लगते हैं।	mAnaka SipiMga meM AmawOra para 3-5 vyAvasAyika xina lagawe hEM.	Standard shipping usually takes 3-5 commercial days.
Ecommerce_FAQ_010b	जबकि एक्सप्रेस शिपिंग में 1-2 व्यावसायिक दिन लग सकते हैं।	jabaki eksapresa SipiMga meM 1-2 vyAvasAyika xina laga sakawe hEM.	While express shipping may take 1-2 commercial days.
Ecommerce_FAQ_011	हाँ, हम चुनिंदा देशों में अंतर्राष्ट्रीय शिपिंग प्रदान करते हैं।	hAz, hama cuniMxA xeSoM meM aMwarrARtrIya SipiMga praxAna karawe hEM.	Yes, we provide international shipping in select countries.
Ecommerce_FAQ_012	उपलब्धता और शिपिंग लागत की गणना आपके स्थान के आधार पर चेकआउट प्रक्रिया के दौरान की जाएगी।	upalabXawA Ora SipiMga lAgawa kI gaNanA Apake sWAna ke AXAra para cekaAuta prakriyA ke xOrAna kI jAegI.	Availability and shipping costs will be calculated during the checkout process based on your location.
Ecommerce_FAQ_013a	आपका पैकेज ट्रांज़िट के दौरान खो गया है ।	ApakA pEkeja trAMjZita ke xOrAna Ko gayA hE .	Your package is lost during transit.
Ecommerce_FAQ_013b	या वह क्षतिग्रस्त हो गया है ।	yA vaha kRawigraswa ho gayA hE .	Or he is damaged.
Ecommerce_FAQ_013c	तो कृपया तुरंत हमारी ग्राहक सहायता टीम से संपर्क करें।	wo kqpayA wuraMwa hamArI grAhaka sahAyawA tIma se saMparka kareM.	So please contact our customer aid team immediately.
Ecommerce_FAQ_014a	हम जांच शुरू करेंगे ।	hama jAMca SurU kareMge .	We will start investigation.
Ecommerce_FAQ_014b	और हम समस्या को हल करने के लिए आवश्यक कदम उठाएंगे।	Ora hama samasyA ko hala karane ke lie AvaSyaka kaxama uTAeMge.	And we will take necessary steps to solve the problem.
Ecommerce_FAQ_015a	आपको अपना शिपिंग पता बदलने की आवश्यकता है।	Apako apanA SipiMga pawA baxalane kI AvaSyakawA hE.	You need to change your shipping address.
Ecommerce_FAQ_015b	तो कृपया जल्द से जल्द हमारी ग्राहक सहायता टीम से संपर्क करें।	wo kqpayA jalxa se jalxa hamArI grAhaka sahAyawA tIma se saMparka kareM.	So please contact our customer aid team as soon as possible.
Ecommerce_FAQ_016a	ऑर्डर अभी तक शिप नहीं किया गया है ।	OYrdara aBI waka Sipa nahIM kiyA gayA hE .	The order has not been shipped yet.
Ecommerce_FAQ_016b	तो हम पता अपडेट करने की पूरी कोशिश करेंगे।	wo hama pawA apadeta karane kI pUrI koSiSa kareMge.	So we will try our best to update the address.
Ecommerce_FAQ_017	आप हमारी ग्राहक सहायता टीम से फ़ोन नंबर पर फ़ोन करके या ईमेल पता पर ईमेल करके संपर्क कर सकते हैं।	Apa hamArI grAhaka sahAyawA tIma se PZona naMbara para PZona karake yA Imela pawA para Imela karake saMparka kara sakawe hEM.	You can contact our customer aid team by calling the phone number or by emailing the email address.
Ecommerce_FAQ_018	हमारी टीम आपकी किसी भी पूछताछ या समस्या में सहायता करने के लिए कार्य समय उपलब्ध है।	hamArI tIma ApakI kisI BI pUCawACa yA samasyA meM sahAyawA karane ke lie kArya samaya upalabXa hE.	Our team is available to work time to help you any inquiry or problem.
Ecommerce_FAQ_019	हाँ, हम अतिरिक्त शुल्क के लिए उपहार रैपिंग सेवाएँ प्रदान करते हैं।	hAz, hama awirikwa Sulka ke lie upahAra rEpiMga sevAez praxAna karawe hEM.	Yes, we provide gifts for additional fees rapping services.
Ecommerce_FAQ_020	चेकआउट प्रक्रिया के दौरान, आप अपने ऑर्डर में उपहार रैपिंग जोड़ने का विकल्प चुन सकते हैं।	cekaAuta prakriyA ke xOrAna, Apa apane OYrdara meM upahAra rEpiMga jodZane kA vikalpa cuna sakawe hEM.	During the checkout process, you can choose to add gift rapping to your order.
Ecommerce_FAQ_021	हमारे पास एक मूल्य मिलान नीति है, जिसके तहत हम प्रतिस्पर्धी की वेबसाइट पर पाए जाने वाले समान उत्पाद की कीमत का मिलान करेंगे।	hamAre pAsa eka mUlya milAna nIwi hE, jisake wahawa hama prawisparXI kI vebasAita para pAe jAne vAle samAna uwpAxa kI kImawa kA milAna kareMge.	We have a price matching policy, under which we will match the price of the same product found on the competitor's website.
Ecommerce_FAQ_022	कृपया उत्पाद के विवरण और प्रतिस्पर्धी के ऑफ़र के साथ हमारी ग्राहक सहायता टीम से संपर्क करें।	kqpayA uwpAxa ke vivaraNa Ora prawisparXI ke OYPZara ke sAWa hamArI grAhaka sahAyawA tIma se saMparka kareM.	Please contact our customer aid team with the product details and competing offers.
Ecommerce_FAQ_023	दुर्भाग्य से, हम फ़ोन पर ऑर्डर स्वीकार नहीं करते हैं।	xurBAgya se, hama PZona para OYrdara svIkAra nahIM karawe hEM.	Unfortunately, we do not accept the order on the phone.
Ecommerce_FAQ_024	कृपया एक सहज और सुरक्षित लेनदेन के लिए हमारी वेबसाइट के माध्यम से अपना ऑर्डर दें।	kqpayA eka sahaja Ora surakRiwa lenaxena ke lie hamArI vebasAita ke mAXyama se apanA OYrdara xeM.	Please order your order through our website for a spontaneous and safe transaction.
Ecommerce_FAQ_025	हाँ, हम आपकी व्यक्तिगत और भुगतान जानकारी की सुरक्षा को गंभीरता से लेते हैं।	hAz, hama ApakI vyakwigawa Ora BugawAna jAnakArI kI surakRA ko gaMBIrawA se lewe hEM.	Yes, we take the protection of your personal and payment information seriously.
Ecommerce_FAQ_026a	हम उद्योग-मानक एन्क्रिप्शन का उपयोग करते हैं ।	hama uxyoga-mAnaka enkripSana kA upayoga karawe hEM .	We use industry-standard encryption.
Ecommerce_FAQ_026b	और हम आपकी जानकारी की सुरक्षा सुनिश्चित करने के लिए सख्त सुरक्षा प्रोटोकॉल का पालन करते हैं।	Ora hama ApakI jAnakArI kI surakRA suniSciwa karane ke lie saKwa surakRA protokOYla kA pAlana karawe hEM.	And we follow strict safety protocols to ensure the safety of your information.
Ecommerce_FAQ_027a	आपके द्वारा खरीदा गया कोई उत्पाद आपकी खरीद के 7 दिनों के भीतर सेल पर चला जाता है ।	Apake xvArA KarIxA gayA koI uwpAxa ApakI KarIxa ke 7 xinoM ke BIwara sela para calA jAwA hE .	Any product you bought goes to the cell within 7 days of your purchase.
Ecommerce_FAQ_027b	तो हम एक बार मूल्य समायोजन प्रदान करते हैं।	wo hama eka bAra mUlya samAyojana praxAna karawe hEM.	So we provide price adjustments once.
Ecommerce_FAQ_028	समायोजन का अनुरोध करने के लिए कृपया अपने ऑर्डर विवरण के साथ हमारी ग्राहक सहायता टीम से संपर्क करें।	samAyojana kA anuroXa karane ke lie kqpayA apane OYrdara vivaraNa ke sAWa hamArI grAhaka sahAyawA tIma se saMparka kareM.	Please contact our customer aid team with your order details to request the adjustment.
Ecommerce_FAQ_029	हां, हमारे पास एक लॉयल्टी प्रोग्राम है जहां आप हर खरीद के लिए अंक अर्जित कर सकते हैं।	hAM, hamAre pAsa eka lOYyaltI progrAma hE jahAM Apa hara KarIxa ke lie aMka arjiwa kara sakawe hEM.	Yes, we have a loyalty program where you can earn marks for every purchase.
Ecommerce_FAQ_030	इन अंकों को भविष्य के ऑर्डर पर छूट के लिए भुनाया जा सकता है।	ina aMkoM ko BaviRya ke OYrdara para CUta ke lie BunAyA jA sakawA hE.	These digits can be redeemed for exemption on future orders.
Ecommerce_FAQ_031	कृपया अधिक जानने और कार्यक्रम में शामिल होने के लिए हमारी वेबसाइट पर जाएं।	kqpayA aXika jAnane Ora kAryakrama meM SAmila hone ke lie hamArI vebasAita para jAeM.	Please go to our website to know more and join the program.
Ecommerce_FAQ_032	हां, आप खाता बनाए बिना अतिथि के रूप में ऑर्डर दे सकते हैं।	hAM, Apa KAwA banAe binA awiWi ke rUpa meM OYrdara xe sakawe hEM.	Yes, you can order as a guest without creating an account.
Ecommerce_FAQ_033	हालांकि, खाता बनाने से ऑर्डर ट्रैकिंग और भविष्य की आसान खरीदारी जैसे लाभ मिलते हैं।	hAlAMki, KAwA banAne se OYrdara trEkiMga Ora BaviRya kI AsAna KarIxArI jEse lABa milawe hEM.	However, creating an account provides benefits such as order tracking and easy future purchases.
Ecommerce_FAQ_034	हां, हम कुछ उत्पादों के लिए थोक या थोक छूट प्रदान करते हैं।	hAM, hama kuCa uwpAxoM ke lie Woka yA Woka CUta praxAna karawe hEM.	Yes, we provide wholesale or bulk discounts for some products.
Ecommerce_FAQ_035a	अधिक जानकारी के लिए और अपनी विशिष्ट आवश्यकताओं पर चर्चा करने के लिए कृपया हमारी ग्राहक सहायता टीम से संपर्क करें ।	aXika jAnakArI ke lie Ora apanI viSiRta AvaSyakawAoM para carcA karane ke lie kqpayA hamArI grAhaka sahAyawA tIma se saMparka kareM .	For more information and to discuss your specific requirements, please contact our customer aid team.
Ecommerce_FAQ_035b	या अधिक जानकारी के लिए और अपनी विशिष्ट आवश्यकताओं पर चर्चा करने के लिए कृपया हमारे थोक पृष्ठ पर जाएँ।	yA aXika jAnakArI ke lie Ora apanI viSiRta AvaSyakawAoM para carcA karane ke lie kqpayA hamAre Woka pqRTa para jAez.	Or please go to our wholesale page for more information and to discuss your specific requirements.
Ecommerce_FAQ_036a	आपको अपने ऑर्डर में कोई आइटम बदलने या रद्द करने की आवश्यकता है ।	Apako apane OYrdara meM koI Aitama baxalane yA raxxa karane kI AvaSyakawA hE .	You need to change or cancel an item in your order.
Ecommerce_FAQ_036b	तो कृपया जितनी जल्दी हो सके हमारी ग्राहक सहायता टीम से संपर्क करें।	wo kqpayA jiwanI jalxI ho sake hamArI grAhaka sahAyawA tIma se saMparka kareM.	So please contact our customer aid team as soon as possible.
Ecommerce_FAQ_037	हम आवश्यक चरणों में आपकी सहायता करेंगे।	hama AvaSyaka caraNoM meM ApakI sahAyawA kareMge.	We will help you in the required stages.
Ecommerce_FAQ_038a	उत्पाद समीक्षा देने के लिए, हमारी वेबसाइट पर उत्पाद पृष्ठ पर जाएँ ।	uwpAxa samIkRA xene ke lie, hamArI vebasAita para uwpAxa pqRTa para jAez .	To give product reviews, go to the product page on our website.
Ecommerce_FAQ_038b	और 'समीक्षा लिखें' बटन पर क्लिक करें।	Ora 'samIkRA liKeM' batana para klika kareM.	And click on the 'Write Review' button.
Ecommerce_FAQ_039	आप उत्पाद के साथ अपने अनुभव के आधार पर अपनी प्रतिक्रिया और रेटिंग साझा कर सकते हैं।	Apa uwpAxa ke sAWa apane anuBava ke AXAra para apanI prawikriyA Ora retiMga sAJA kara sakawe hEM.	You can share your feedback and rating based on your experience with the product.
Ecommerce_FAQ_040	आमतौर पर, प्रत्येक ऑर्डर पर केवल एक प्रोमो कोड लागू किया जा सकता है।	AmawOra para, prawyeka OYrdara para kevala eka promo koda lAgU kiyA jA sakawA hE.	Typically, only one promo code can be applied on each order.
Ecommerce_FAQ_041	चेकआउट प्रक्रिया के दौरान, अपने ऑर्डर पर छूट लागू करने के लिए निर्दिष्ट फ़ील्ड में प्रोमो कोड दर्ज करें।	cekaAuta prakriyA ke xOrAna, apane OYrdara para CUta lAgU karane ke lie nirxiRta PZIlda meM promo koda xarja kareM.	During the checkout process, enter the promo code in the specified field to apply discounts on your order.
Ecommerce_FAQ_042a	आपको अपने ऑर्डर में गलत आइटम मिलता है ।	Apako apane OYrdara meM galawa Aitama milawA hE .	You get the wrong item in your order.
Ecommerce_FAQ_042b	तो कृपया तुरंत हमारी ग्राहक सहायता टीम से संपर्क करें।	wo kqpayA wuraMwa hamArI grAhaka sahAyawA tIma se saMparka kareM.	So please contact our customer aid team immediately.
Ecommerce_FAQ_043a	हम आपके लिए सही आइटम भेजने की व्यवस्था करेंगे ।	hama Apake lie sahI Aitama Bejane kI vyavasWA kareMge .	We will arrange to send the right items for you.
Ecommerce_FAQ_043b	और हम गलत आइटम को वापस करने में सहायता करेंगे।	Ora hama galawa Aitama ko vApasa karane meM sahAyawA kareMge.	And we will help return the wrong items.
Ecommerce_FAQ_044	हाँ, हम तेज़ डिलीवरी के लिए शीघ्र शिपिंग विकल्प प्रदान करते हैं।	hAz, hama wejZa dilIvarI ke lie SIGra SipiMga vikalpa praxAna karawe hEM.	Yes, we provide early shipping options for fast delivery.
Ecommerce_FAQ_045	चेकआउट प्रक्रिया के दौरान, आप इच्छित शीघ्र शिपिंग विधि का चयन कर सकते हैं।	cekaAuta prakriyA ke xOrAna, Apa icCiwa SIGra SipiMga viXi kA cayana kara sakawe hEM.	During the checkout process, you can choose the desired quick shipping method.
Ecommerce_FAQ_046a	कोई उत्पाद वर्तमान में स्टॉक में नहीं है ।	koI uwpAxa varwamAna meM stOYka meM nahIM hE .	No product is currently in stock.
Ecommerce_FAQ_046b	तो आपको आमतौर पर उत्पाद सूचनाओं के लिए साइन अप करने का विकल्प दिखाई देगा।	wo Apako AmawOra para uwpAxa sUcanAoM ke lie sAina apa karane kA vikalpa xiKAI xegA.	So you will usually see the option to sign up for product information.
Ecommerce_FAQ_047a	इस तरह, जब उत्पाद फिर से उपलब्ध होगा ।	isa waraha, jaba uwpAxa Pira se upalabXa hogA .	In this way, when the product will be available again.
Ecommerce_FAQ_047b	तो आपको सूचित किया जाएगा।	wo Apako sUciwa kiyA jAegA.	So you will be informed.
Ecommerce_FAQ_048	हमारा ईमेल न्यूज़लेटर नए उत्पाद रिलीज़, विशेष ऑफ़र और हमारे उत्पादों से संबंधित उपयोगी सुझावों पर अपडेट प्रदान करता है।	hamArA Imela nyUjZaletara nae uwpAxa rilIjZa, viSeRa OYPZara Ora hamAre uwpAxoM se saMbaMXiwa upayogI suJAvoM para apadeta praxAna karawA hE.	Our email newsletter provides updates on new product release, special offers and useful suggestions related to our products.
Ecommerce_FAQ_049	आप हमारी वेबसाइट पर हमारे न्यूज़लेटर की सदस्यता ले सकते हैं।	Apa hamArI vebasAita para hamAre nyUjZaletara kI saxasyawA le sakawe hEM.	You can subscribe to our newsletter on our website.
Ecommerce_FAQ_050a	हाँ, आप अपना विचार बदलते हैं ।	hAz, Apa apanA vicAra baxalawe hEM .	Yes, you change your thoughts.
Ecommerce_FAQ_050b	तो आप उत्पाद वापस कर सकते हैं।	wo Apa uwpAxa vApasa kara sakawe hEM.	So you can return the product.
Ecommerce_FAQ_051a	कृपया आप यह सुनिश्चित करें ।	kqpayA Apa yaha suniSciwa kareM .	Please make sure you.
Ecommerce_FAQ_051b	कि उत्पाद अपनी मूल स्थिति और पैकेजिंग में है ।	ki uwpAxa apanI mUla sWiwi Ora pEkejiMga meM hE .	That the product is in its original status and packaging.
Ecommerce_FAQ_051c	और निर्देशों के लिए हमारी वापसी नीति देखें ।	Ora nirxeSoM ke lie hamArI vApasI nIwi xeKeM .	And see our return policy for instructions.
Ecommerce_FAQ_052	हाँ, हम अपने व्यावसायिक घंटों के दौरान अपनी वेबसाइट पर लाइव चैट सहायता प्रदान करते हैं।	hAz, hama apane vyAvasAyika GaMtoM ke xOrAna apanI vebasAita para lAiva cEta sahAyawA praxAna karawe hEM.	Yes, we provide live chat support on our website during our business hours.
Ecommerce_FAQ_053	हमारी ग्राहक सहायता टीम के साथ चैट शुरू करने के लिए नीचे दाएँ कोने में चैट आइकन देखें।	hamArI grAhaka sahAyawA tIma ke sAWa cEta SurU karane ke lie nIce xAez kone meM cEta Aikana xeKeM.	See the chat icon in the right corner below to start chatting with our customer aid team.
Ecommerce_FAQ_054a	हाँ, आप उपहार के रूप में उत्पाद ऑर्डर कर सकते हैं ।	hAz, Apa upahAra ke rUpa meM uwpAxa OYrdara kara sakawe hEM .	Yes, you can order the product as a gift.
Ecommerce_FAQ_054b	और इसे सीधे प्राप्तकर्ता को भेज सकते हैं।	Ora ise sIXe prApwakarwA ko Beja sakawe hEM.	And can send it directly to the recipient.
Ecommerce_FAQ_055	चेकआउट प्रक्रिया के दौरान, आप प्राप्तकर्ता का शिपिंग पता दर्ज कर सकते हैं।	cekaAuta prakriyA ke xOrAna, Apa prApwakarwA kA SipiMga pawA xarja kara sakawe hEM.	During the checkout process, you can enter the shipping address of the recipient.
Ecommerce_FAQ_056a	आपका डिस्काउंट कोड काम नहीं कर रहा है ।	ApakA diskAuMta koda kAma nahIM kara rahA hE .	Your discount code is not working.
Ecommerce_FAQ_056b	तो कृपया कोड से जुड़े नियमों और शर्तों को दोबारा जाँच लें।	wo kqpayA koda se judZe niyamoM Ora SarwoM ko xobArA jAzca leM.	So please check the terms and conditions related to the code.
Ecommerce_FAQ_057a	समस्या बनी रहती है ।	samasyA banI rahawI hE .	The problem persists.
Ecommerce_FAQ_057b	तो सहायता के लिए हमारी ग्राहक सहायता टीम से संपर्क करें।	wo sahAyawA ke lie hamArI grAhaka sahAyawA tIma se saMparka kareM.	So contact our customer aid team for assistance.
Ecommerce_FAQ_058	अंतिम सेल आइटम आमतौर पर वापसी योग्य और धनवापसी योग्य नहीं होते हैं।	aMwima sela Aitama AmawOra para vApasI yogya Ora XanavApasI yogya nahIM howe hEM.	Final cell items are usually not returnable and refundable.
Ecommerce_FAQ_059a	कृपया उत्पाद विवरण की समीक्षा करें ।	kqpayA uwpAxa vivaraNa kI samIkRA kareM .	Please review the product details.
Ecommerce_FAQ_059b	या विशिष्ट आइटम के लिए वापसी पात्रता की पुष्टि करने के लिए हमारी ग्राहक सहायता टीम से संपर्क करें।	yA viSiRta Aitama ke lie vApasI pAwrawA kI puRti karane ke lie hamArI grAhaka sahAyawA tIma se saMparka kareM.	Or contact our customer aid team to confirm the return eligibility for specific items.
Ecommerce_FAQ_060	चुनिंदा उत्पादों के लिए इंस्टॉलेशन सेवाएँ उपलब्ध हैं।	cuniMxA uwpAxoM ke lie iMstOYleSana sevAez upalabXa hEM.	Installation services are available for selected products.
Ecommerce_FAQ_061a	#कृपया उत्पाद विवरण देखें या अधिक जानकारी के लिए और इंस्टॉलेशन सेवाओं का अनुरोध करने के लिए हमारी ग्राहक सहायता टीम से संपर्क करें।	#kqpayA uwpAxa vivaraNa xeKeM yA aXika jAnakArI ke lie Ora iMstOYleSana sevAoM kA anuroXa karane ke lie hamArI grAhaka sahAyawA tIma se saMparka kareM.	#Please see the product details or contact our customer aid team for more information and requesting installation services.
Ecommerce_FAQ_061b	#या अधिक जानकारी के लिए और इंस्टॉलेशन सेवाओं का अनुरोध करने के लिए हमारी ग्राहक सहायता टीम से संपर्क करें।	#yA aXika jAnakArI ke lie Ora iMstOYleSana sevAoM kA anuroXa karane ke lie hamArI grAhaka sahAyawA tIma se saMparka kareM.	#For more information and contact our customer aid team to request installation services.
Ecommerce_FAQ_062	बंद हो चुके उत्पाद अब खरीद के लिए उपलब्ध नहीं हैं।	baMxa ho cuke uwpAxa aba KarIxa ke lie upalabXa nahIM hEM.	Closed products are no longer available for purchase.
Ecommerce_FAQ_063	हम अपनी वेबसाइट पर वैकल्पिक उत्पादों की खोज करने की सलाह देते हैं।	hama apanI vebasAita para vEkalpika uwpAxoM kI Koja karane kI salAha xewe hEM.	We recommend searching alternative products on our website.
Ecommerce_FAQ_064	आम तौर पर रिटर्न के लिए रसीद या खरीद का प्रमाण आवश्यक होता है।	Ama wOra para ritarna ke lie rasIxa yA KarIxa kA pramANa AvaSyaka howA hE.	Generally, proof of receipt or purchase is necessary for returns.
Ecommerce_FAQ_065a	#कृपया हमारी वापसी नीति देखें ।	#kqpayA hamArI vApasI nIwi xeKeM .	#Please see our return policy.
Ecommerce_FAQ_065b	#या सहायता के लिए हमारी ग्राहक सहायता टीम से संपर्क करें।	#yA sahAyawA ke lie hamArI grAhaka sahAyawA tIma se saMparka kareM.	#Or contact our customer aid team for assistance.
Ecommerce_FAQ_066	हाँ, हम चुनिंदा देशों में अंतर्राष्ट्रीय शिपिंग प्रदान करते हैं।	hAz, hama cuniMxA xeSoM meM aMwarrARtrIya SipiMga praxAna karawe hEM.	Yes, we provide international shipping in select countries.
Ecommerce_FAQ_067a	#कृपया चेकआउट के दौरान उपलब्ध शिपिंग गंतव्यों की समीक्षा करें।	#kqpayA cekaAuta ke xOrAna upalabXa SipiMga gaMwavyoM kI samIkRA kareM.	#Please review the shipping destinations available during the checkout.
Ecommerce_FAQ_067b	#या सहायता के लिए हमारे ग्राहक सहायता से संपर्क करें।	#yA sahAyawA ke lie hamAre grAhaka sahAyawA se saMparka kareM.	#Or contact with our customer aid for help.
Ecommerce_FAQ_068	हाँ, आप चेकआउट प्रक्रिया के दौरान उपहार संदेश जोड़ सकते हैं।	hAz, Apa cekaAuta prakriyA ke xOrAna upahAra saMxeSa jodZa sakawe hEM.	Yes, you can add gift messages during the checkout process.
Ecommerce_FAQ_069	आम तौर पर यह एक अनुभाग होता है जहाँ आप अपना व्यक्तिगत संदेश दर्ज कर सकते हैं।	Ama wOra para yaha eka anuBAga howA hE jahAz Apa apanA vyakwigawa saMxeSa xarja kara sakawe hEM.	It is usually a section where you can enter your personal message.
Ecommerce_FAQ_070	हम वर्तमान में खरीदारी से पहले उत्पाद प्रदर्शन की पेशकश नहीं करते हैं।	hama varwamAna meM KarIxArI se pahale uwpAxa praxarSana kI peSakaSa nahIM karawe hEM.	We currently do not offer product performance before shopping.
Ecommerce_FAQ_071	हालाँकि, आप हमारी वेबसाइट पर विस्तृत उत्पाद विवरण, विनिर्देश और ग्राहक समीक्षाएँ पा सकते हैं।	hAlAzki, Apa hamArI vebasAita para viswqwa uwpAxa vivaraNa, vinirxeSa Ora grAhaka samIkRAez pA sakawe hEM.	However, you can find detailed product details, specifications and customer reviews on our website.
Ecommerce_FAQ_072	'जल्द ही आने वाला' के रूप में सूचीबद्ध उत्पाद तत्काल खरीद के लिए उपलब्ध नहीं हैं।	'jalxa hI Ane vAlA' ke rUpa meM sUcIbaxXa uwpAxa wawkAla KarIxa ke lie upalabXa nahIM hEM.	The products listed as 'soon' are not available for immediate purchase.
Ecommerce_FAQ_073	कृपया उत्पाद उपलब्ध होने पर सूचित करने के लिए अधिसूचनाओं के लिए साइन अप करें।	kqpayA uwpAxa upalabXa hone para sUciwa karane ke lie aXisUcanAoM ke lie sAina apa kareM.	Please sign up for notifications to inform when the product is available.
Ecommerce_FAQ_074	हाँ, आमतौर पर आपके ऑर्डर के साथ इनवॉइस शामिल होता है।	hAz, AmawOra para Apake OYrdara ke sAWa inavOYisa SAmila howA hE.	Yes, your order usually involves invoice.
Ecommerce_FAQ_075a	आपको अलग से इनवॉइस की आवश्यकता है ।	Apako alaga se inavOYisa kI AvaSyakawA hE .	You need separate invoice.
Ecommerce_FAQ_075b	तो कृपया अपने ऑर्डर विवरण के साथ हमारी ग्राहक सहायता टीम से संपर्क करें।	wo kqpayA apane OYrdara vivaraNa ke sAWa hamArI grAhaka sahAyawA tIma se saMparka kareM.	So please contact our customer aid team with your order details.
Ecommerce_FAQ_076	'सीमित संस्करण' उत्पादों की उपलब्धता सीमित हो सकती है।	'sImiwa saMskaraNa' uwpAxoM kI upalabXawA sImiwa ho sakawI hE.	The availability of 'limited version' products may be limited.
Ecommerce_FAQ_077	हम आपके आइटम को सुरक्षित करने के लिए जल्द से जल्द ऑर्डर देने की सलाह देते हैं।	hama Apake Aitama ko surakRiwa karane ke lie jalxa se jalxa OYrdara xene kI salAha xewe hEM.	We recommend ordering as soon as possible to secure your item.
Ecommerce_FAQ_078a	जबकि किसी उत्पाद को उसकी मूल पैकेजिंग में वापस करना बेहतर होता है ।	jabaki kisI uwpAxa ko usakI mUla pEkejiMga meM vApasa karanA behawara howA hE .	Whereas it is better to return a product to its original packaging.
Ecommerce_FAQ_078b	आप उसके बिना भी वापसी शुरू कर सकते हैं।	Apa usake binA BI vApasI SurU kara sakawe hEM.	You can start a comeback even without him.
Ecommerce_FAQ_079	ऐसे मामलों में मार्गदर्शन के लिए हमारी ग्राहक सहायता टीम से संपर्क करें।	Ese mAmaloM meM mArgaxarSana ke lie hamArI grAhaka sahAyawA tIma se saMparka kareM.	In such cases, contact our customer aid team for guidance.
Ecommerce_FAQ_080	हम स्टॉक में नहीं आने वाले उत्पादों के लिए आरक्षण प्रदान नहीं करते हैं।	hama stOYka meM nahIM Ane vAle uwpAxoM ke lie ArakRaNa praxAna nahIM karawe hEM.	We do not provide reservation for products not coming in stock.
Ecommerce_FAQ_081a	हालाँकि, आप उत्पाद सूचनाओं के लिए साइन अप कर सकते हैं ।	hAlAzki, Apa uwpAxa sUcanAoM ke lie sAina apa kara sakawe hEM .	However, you can sign up for product information.
Ecommerce_FAQ_081b	ताकि जब यह फिर से उपलब्ध हो जाए।	wAki jaba yaha Pira se upalabXa ho jAe.	So that it becomes available again.
Ecommerce_FAQ_081c	तो आपको सूचित किया जा सके।	wo Apako sUciwa kiyA jA sake.	So you can be informed.
Ecommerce_FAQ_082	हाँ, आप प्री-ऑर्डर और इन-स्टॉक आइटम के मिश्रण के साथ ऑर्डर दे सकते हैं।	hAz, Apa prI-OYrdara Ora ina-stOYka Aitama ke miSraNa ke sAWa OYrdara xe sakawe hEM.	Yes, you can order with a mixture of pre-order and in-stock items.
Ecommerce_FAQ_083a	हालाँकि, कृपया ध्यान दें कि सभी आइटम उपलब्ध होने के बाद पूरा ऑर्डर भेजा जाएगा।	hAlAzki, kqpayA XyAna xeM ki saBI Aitama upalabXa hone ke bAxa pUrA OYrdara BejA jAegA.	However, please note that the full order will be sent after all the items are available.
Ecommerce_FAQ_083b	कि सभी आइटम उपलब्ध होने के बाद पूरा ऑर्डर भेजा जाएगा।	ki saBI Aitama upalabXa hone ke bAxa pUrA OYrdara BejA jAegA.	That the entire order will be sent after all the items are available.
Ecommerce_FAQ_084a	आपका उत्पाद शिपिंग के दौरान क्षतिग्रस्त हो गया था ।	ApakA uwpAxa SipiMga ke xOrAna kRawigraswa ho gayA WA .	Your product was damaged during shipping.
Ecommerce_FAQ_084b	तो कृपया तुरंत हमारी ग्राहक सहायता टीम से संपर्क करें।	wo kqpayA wuraMwa hamArI grAhaka sahAyawA tIma se saMparka kareM.	So please contact our customer aid team immediately.
Ecommerce_FAQ_085	हम आपको वापसी और रिप्लेस्मेंट प्रक्रिया के माध्यम से मार्गदर्शन करेंगे।	hama Apako vApasI Ora riplesmeMta prakriyA ke mAXyama se mArgaxarSana kareMge.	We will guide you through return and replacement process.
Ecommerce_FAQ_086	हम जब भी संभव हो लोकप्रिय उत्पादों को फिर से स्टॉक करने का प्रयास करते हैं।	hama jaba BI saMBava ho lokapriya uwpAxoM ko Pira se stOYka karane kA prayAsa karawe hEM.	We try to re -stock popular products whenever possible.
Ecommerce_FAQ_087a	कृपया उत्पाद सूचनाओं के लिए साइन अप करें ।	kqpayA uwpAxa sUcanAoM ke lie sAina apa kareM .	Please sign up for product information.
Ecommerce_FAQ_087b	ताकि जब आइटम फिर से उपलब्ध हो जाए।	wAki jaba Aitama Pira se upalabXa ho jAe.	So that the item becomes available again.
Ecommerce_FAQ_087c	तो आपको सूचित किया जा सके।	wo Apako sUciwa kiyA jA sake.	So you can be informed.
Ecommerce_FAQ_088a	'बैकऑर्डर' के रूप में सूचीबद्ध उत्पाद अस्थायी रूप से स्टॉक से बाहर हैं ।	'bEkaOYrdara' ke rUpa meM sUcIbaxXa uwpAxa asWAyI rUpa se stOYka se bAhara hEM .	The products listed as 'back orders' are temporarily out of stock.
Ecommerce_FAQ_088b	लेकिन फिर भी ऑर्डर किए जा सकते हैं।	lekina Pira BI OYrdara kie jA sakawe hEM.	But still orders can be made.
Ecommerce_FAQ_089	उत्पाद के फिर से स्टॉक होने पर आपका ऑर्डर पूरा हो जाएगा।	uwpAxa ke Pira se stOYka hone para ApakA OYrdara pUrA ho jAegA.	Your order will be fulfilled when the product is re -stock.
Ecommerce_FAQ_090	हाँ, आप से के दौरान या छूट के साथ खरीदे गए उत्पाद को वापस कर सकते हैं।	hAz, Apa se ke xOrAna yA CUta ke sAWa KarIxe gae uwpAxa ko vApasa kara sakawe hEM.	Yes, you can return the product purchased during or with discounts.
Ecommerce_FAQ_091	छूट के बाद भुगतान की गई राशि के आधार पर रिफ़ंड प्रोसेस किया जाएगा।	CUta ke bAxa BugawAna kI gaI rASi ke AXAra para riPZMda prosesa kiyA jAegA.	Refund will be processed based on the amount paid after the exemption.
Ecommerce_FAQ_092a	आपको कोई क्षतिग्रस्त उत्पाद प्राप्त होता है ।	Apako koI kRawigraswa uwpAxa prApwa howA hE .	You receive a damaged product.
Ecommerce_FAQ_092b	तो कृपया हमारी ग्राहक सहायता टीम से तुरंत संपर्क करें।	wo kqpayA hamArI grAhaka sahAyawA tIma se wuraMwa saMparka kareM.	So please contact our customer aid team immediately.
Ecommerce_FAQ_093	हम मरम्मत या रिप्लेस्मेंट के लिए आवश्यक चरणों में आपकी सहायता करेंगे।	hama marammawa yA riplesmeMta ke lie AvaSyaka caraNoM meM ApakI sahAyawA kareMge.	We will help you in the stages required for repair or replacement.
Ecommerce_FAQ_094a	कोई उत्पाद प्री-ऑर्डर के लिए उपलब्ध है ।	koI uwpAxa prI-OYrdara ke lie upalabXa hE .	Any product is available for pre-order.
Ecommerce_FAQ_094b	तो आप अपना आइटम सुरक्षित करने के लिए ऑर्डर दे सकते हैं।	wo Apa apanA Aitama surakRiwa karane ke lie OYrdara xe sakawe hEM.	So you can order to secure your item.
Ecommerce_FAQ_095	उत्पाद उपलब्ध होने पर उसे भेज दिया जाएगा।	uwpAxa upalabXa hone para use Beja xiyA jAegA.	If the product is available, it will be sent.
Ecommerce_FAQ_096	हाँ, आप उपहार के रूप में खरीदे गए उत्पाद को वापस कर सकते हैं।	hAz, Apa upahAra ke rUpa meM KarIxe gae uwpAxa ko vApasa kara sakawe hEM.	Yes, you can return the product purchased as a gift.
Ecommerce_FAQ_097	हालाँकि, आम तौर पर खरीद के लिए उपयोग की गई मूल भुगतान विधि से धनवापसी जारी की जाएगी।	hAlAzki, Ama wOra para KarIxa ke lie upayoga kI gaI mUla BugawAna viXi se XanavApasI jArI kI jAegI.	However, a correspondence will be issued by the original payment method used for purchase.
Ecommerce_FAQ_098a	दुर्भाग्य से किसी उत्पाद को 'बंद' के रूप में सूचीबद्ध किया गया है ।	xurBAgya se kisI uwpAxa ko 'baMxa' ke rUpa meM sUcIbaxXa kiyA gayA hE .	Unfortunately a product is listed as 'closed'.
Ecommerce_FAQ_098b	तो वह अब खरीद के लिए उपलब्ध नहीं है।	wo vaha aba KarIxa ke lie upalabXa nahIM hE.	So it is no longer available for purchase.
Ecommerce_FAQ_099	हम अपनी वेबसाइट पर वैकल्पिक उत्पादों की खोज करने की सलाह देते हैं।	hama apanI vebasAita para vEkalpika uwpAxoM kI Koja karane kI salAha xewe hEM.	We recommend searching alternative products on our website.
Ecommerce_FAQ_100a	कोई उत्पाद 'बिक चुका है' के रूप में सूचीबद्ध है ।	koI uwpAxa 'bika cukA hE' ke rUpa meM sUcIbaxXa hE .	Any product is listed as 'sold'.
Ecommerce_FAQ_100b	तो वह वर्तमान में खरीद के लिए उपलब्ध नहीं है।	wo vaha varwamAna meM KarIxa ke lie upalabXa nahIM hE.	So it is not currently available for purchase.
Ecommerce_FAQ_101a	कृपया बाद में फिर से जाँच करें ।	kqpayA bAxa meM Pira se jAzca kareM .	Please check again later.
Ecommerce_FAQ_101b	या उपलब्ध होने पर सूचना प्राप्त करने के लिए साइन अप करें।	yA upalabXa hone para sUcanA prApwa karane ke lie sAina apa kareM.	Or sign up to get information when available.
Ecommerce_FAQ_102	हाँ, आप उपहार कार्ड से खरीदे गए उत्पाद को वापस कर सकते हैं।	hAz, Apa upahAra kArda se KarIxe gae uwpAxa ko vApasa kara sakawe hEM.	Yes, you can return the product purchased from the gift card.
Ecommerce_FAQ_103	रिफ़ंड स्टोर क्रेडिट या नए उपहार कार्ड के रूप में जारी किया जाएगा।	riPZMda stora kredita yA nae upahAra kArda ke rUpa meM jArI kiyA jAegA.	Refund will be issued as store credit or new gift cards.
Ecommerce_FAQ_104a	कोई उत्पाद आपके साइज में उपलब्ध नहीं है ।	koI uwpAxa Apake sAija meM upalabXa nahIM hE .	No product is available in your size.
Ecommerce_FAQ_104b	तो यह अस्थायी रूप से स्टॉक से बाहर हो सकता है।	wo yaha asWAyI rUpa se stOYka se bAhara ho sakawA hE.	So it can be temporarily out of stock.
Ecommerce_FAQ_105a	कृपया बाद में फिर से जाँच करें।	kqpayA bAxa meM Pira se jAzca kareM.	Please check again later.
Ecommerce_FAQ_105b	या साइज सूचना के लिए साइन अप करें।	yA sAija sUcanA ke lie sAina apa kareM.	Or sign up for size information.
Ecommerce_FAQ_106a	कोई उत्पाद 'जल्द ही आने वाला' के रूप में सूचीबद्ध है ।	koI uwpAxa 'jalxa hI Ane vAlA' ke rUpa meM sUcIbaxXa hE .	An product is listed as 'soon'.
Ecommerce_FAQ_106b	और वह प्री-ऑर्डर के लिए उपलब्ध है ।	Ora vaha prI-OYrdara ke lie upalabXa hE .	And it is available for pre-order.
Ecommerce_FAQ_106c	तो आप उपलब्ध होने से पहले अपने आइटम को सुरक्षित करने के लिए ऑर्डर दे सकते हैं।	wo Apa upalabXa hone se pahale apane Aitama ko surakRiwa karane ke lie OYrdara xe sakawe hEM.	So you can order to secure your item before it is available.
Ecommerce_FAQ_107	हाँ, आप छूट कोड के साथ खरीदे गए उत्पाद को वापस कर सकते हैं।	hAz, Apa CUta koda ke sAWa KarIxe gae uwpAxa ko vApasa kara sakawe hEM.	Yes, you can return the product purchased with a discount code.
Ecommerce_FAQ_108	छूट के बाद भुगतान की गई राशि के आधार पर रिफ़ंड प्रोसेस किया जाएगा।	CUta ke bAxa BugawAna kI gaI rASi ke AXAra para riPZMda prosesa kiyA jAegA.	Refund will be processed based on the amount paid after the exemption.
Ecommerce_FAQ_109	हम वर्तमान में कस्टम ऑर्डर या वैयक्तिकृत उत्पाद प्रदान नहीं करते हैं।	hama varwamAna meM kastama OYrdara yA vEyakwikqwa uwpAxa praxAna nahIM karawe hEM.	We currently do not offer custom orders or personalized products.
Ecommerce_FAQ_110	कृपया हमारी वेबसाइट पर उपलब्ध उत्पादों का पता लगाएँ।	kqpayA hamArI vebasAita para upalabXa uwpAxoM kA pawA lagAez.	Please find out the products available on our website.
Ecommerce_FAQ_111a	कोई उत्पाद 'अस्थायी रूप से अनुपलब्ध' के रूप में सूचीबद्ध है ।	koI uwpAxa 'asWAyI rUpa se anupalabXa' ke rUpa meM sUcIbaxXa hE .	An product is listed as 'temporarily unavailable'.
Ecommerce_FAQ_111b	तो वह स्टॉक से बाहर है ।	wo vaha stOYka se bAhara hE .	So he is out of stock.
Ecommerce_FAQ_111c	लेकिन भविष्य में उसे फिर से स्टॉक किया जा सकता है।	lekina BaviRya meM use Pira se stOYka kiyA jA sakawA hE.	But it can be stocked again in future.
Ecommerce_FAQ_112a	कृपया बाद में फिर से जाँचें।	kqpayA bAxa meM Pira se jAzceM.	Please check again later.
Ecommerce_FAQ_112b	या सूचनाओं के लिए साइन अप करें।	yA sUcanAoM ke lie sAina apa kareM.	Or sign up for information.
Ecommerce_FAQ_113	हमारी वापसी नीति आम तौर पर उन उत्पादों को कवर करती है जो आगमन पर दोषपूर्ण या क्षतिग्रस्त हैं।	hamArI vApasI nIwi Ama wOra para una uwpAxoM ko kavara karawI hE jo Agamana para xoRapUrNa yA kRawigraswa hEM.	Our return policy usually covers products that are defective or damaged on arrival.
Ecommerce_FAQ_114	अनुचित उपयोग के कारण हुई क्षति, वापसी के लिए योग्य नहीं हो सकती है।	anuciwa upayoga ke kAraNa huI kRawi, vApasI ke lie yogya nahIM ho sakawI hE.	Damage caused by improper use may not be eligible for return.
Ecommerce_FAQ_115	सहायता के लिए कृपया हमारी ग्राहक सहायता टीम से संपर्क करें।	sahAyawA ke lie kqpayA hamArI grAhaka sahAyawA tIma se saMparka kareM.	Please contact our customer aid team for assistance.
Ecommerce_FAQ_116a	कोई उत्पाद 'जल्द ही आ रहा है' के रूप में सूचीबद्ध है ।	koI uwpAxa 'jalxa hI A rahA hE' ke rUpa meM sUcIbaxXa hE .	A product is listed as 'coming soon'.
Ecommerce_FAQ_116b	लेकिन वह प्री-ऑर्डर के लिए उपलब्ध नहीं है ।	lekina vaha prI-OYrdara ke lie upalabXa nahIM hE .	But it is not available for pre-order.
Ecommerce_FAQ_116c	तो आपको तब तक प्रतीक्षा करनी होगी ।	wo Apako waba waka prawIkRA karanI hogI .	So you have to wait till then.
Ecommerce_FAQ_116d	जब तक कि वह आधिकारिक रूप से रिलीज़ न हो जाए ।	jaba waka ki vaha AXikArika rUpa se rilIjZa na ho jAe .	Until it is officially released.
Ecommerce_FAQ_116e	और जब तक कि वह खरीद के लिए उपलब्ध न हो जाए।	Ora jaba waka ki vaha KarIxa ke lie upalabXa na ho jAe.	And until it becomes available for purchase.
Ecommerce_FAQ_117a	कोई उत्पाद 'होल्ड पर' के रूप में सूचीबद्ध है ।	koI uwpAxa 'holda para' ke rUpa meM sUcIbaxXa hE .	Any product is listed as 'on hold'.
Ecommerce_FAQ_117b	तो वह अस्थायी रूप से खरीद के लिए अनुपलब्ध है।	wo vaha asWAyI rUpa se KarIxa ke lie anupalabXa hE.	So he is unavailable temporarily for purchase.
Ecommerce_FAQ_118a	कृपया बाद में जाँच करें ।	kqpayA bAxa meM jAzca kareM .	Please check later.
Ecommerce_FAQ_118b	या उपलब्ध होने पर सूचना प्राप्त करने के लिए साइन अप करें।	yA upalabXa hone para sUcanA prApwa karane ke lie sAina apa kareM.	Or sign up to get information when available.
Ecommerce_FAQ_119a	जबकि वापसी के लिए रसीद को प्राथमिकता दी जाती है ।	jabaki vApasI ke lie rasIxa ko prAWamikawA xI jAwI hE .	While the receipt is given priority for return.
Ecommerce_FAQ_119b	हम इसके बिना भी आपकी सहायता कर सकते हैं।	hama isake binA BI ApakI sahAyawA kara sakawe hEM.	We can help you even without it.
Ecommerce_FAQ_120	कृपया आगे के मार्गदर्शन के लिए हमारी ग्राहक सहायता टीम से संपर्क करें।	kqpayA Age ke mArgaxarSana ke lie hamArI grAhaka sahAyawA tIma se saMparka kareM.	Please contact our customer aid team for further guidance.
Ecommerce_FAQ_121	एक बार सीमित संस्करण का उत्पाद बिक जाने के बाद, उसे फिर से स्टॉक नहीं किया जा सकता है।	eka bAra sImiwa saMskaraNa kA uwpAxa bika jAne ke bAxa, use Pira se stOYka nahIM kiyA jA sakawA hE.	Once a limited version product is sold, it cannot be stocked again.
Ecommerce_FAQ_122a	सीमित संस्करण के आइटम सीमित समय के लिए ही उपलब्ध होते हैं ।	sImiwa saMskaraNa ke Aitama sImiwa samaya ke lie hI upalabXa howe hEM .	Limited version items are available only for limited time.
Ecommerce_FAQ_122b	इसलिए हम उन्हें उपलब्ध होने पर खरीद लेने की सलाह देते हैं।	isalie hama unheM upalabXa hone para KarIxa lene kI salAha xewe hEM.	So we recommend buying them when available.
Ecommerce_FAQ_123a	कोई उत्पाद 'बंद' के रूप में सूचीबद्ध है ।	koI uwpAxa 'baMxa' ke rUpa meM sUcIbaxXa hE .	Any product is listed as 'closed'.
Ecommerce_FAQ_123b	लेकिन फिर भी वह वेबसाइट पर दिखाई दे रहा है ।	lekina Pira BI vaha vebasAita para xiKAI xe rahA hE .	But still he is visible on the website.
Ecommerce_FAQ_123c	तो यह एक त्रुटि हो सकती है।	wo yaha eka wruti ho sakawI hE.	So this can be an error.
Ecommerce_FAQ_124	कृपया स्पष्टीकरण के लिए हमारी ग्राहक सहायता टीम से संपर्क करें।	kqpayA spaRtIkaraNa ke lie hamArI grAhaka sahAyawA tIma se saMparka kareM.	Please contact our customer aid team for clarification.
Ecommerce_FAQ_125	निकासी या अंतिम सेल आइटम आमतौर पर गैर-वापसी योग्य और गैर-वापसी योग्य होते हैं।	nikAsI yA aMwima sela Aitama AmawOra para gEra-vApasI yogya Ora gEra-vApasI yogya howe hEM.	Withdrawal or final cell items are usually non-worthy and non-worthy.
Ecommerce_FAQ_126a	कृपया उत्पाद विवरण की समीक्षा करें ।	kqpayA uwpAxa vivaraNa kI samIkRA kareM .	Please review the product details.
Ecommerce_FAQ_126b	या अधिक जानकारी के लिए हमारी ग्राहक सहायता टीम से संपर्क करें।	yA aXika jAnakArI ke lie hamArI grAhaka sahAyawA tIma se saMparka kareM.	Or contact our customer aid team for more information.
Ecommerce_FAQ_127a	कोई उत्पाद हमारी वेबसाइट पर सूचीबद्ध नहीं है ।	koI uwpAxa hamArI vebasAita para sUcIbaxXa nahIM hE .	No product is listed on our website.
Ecommerce_FAQ_127b	तो यह खरीद के लिए उपलब्ध नहीं हो सकता है।	wo yaha KarIxa ke lie upalabXa nahIM ho sakawA hE.	So it may not be available for purchase.
Ecommerce_FAQ_128	हम उपलब्ध उत्पादों की खोज करने या आगे की सहायता के लिए हमारी ग्राहक सहायता टीम से संपर्क करने की सलाह देते हैं।	hama upalabXa uwpAxoM kI Koja karane yA Age kI sahAyawA ke lie hamArI grAhaka sahAyawA tIma se saMparka karane kI salAha xewe hEM.	We recommend contacting our customer aid team for searching available products or further assistance.
Ecommerce_FAQ_129a	कोई उत्पाद 'स्टॉक से बाहर' के रूप में सूचीबद्ध है ।	koI uwpAxa 'stOYka se bAhara' ke rUpa meM sUcIbaxXa hE .	No product is listed as 'out of stock'.
Ecommerce_FAQ_129b	लेकिन वह बैकऑर्डर के लिए उपलब्ध है ।	lekina vaha bEkaOYrdara ke lie upalabXa hE .	But it is available for back order.
Ecommerce_FAQ_129c	तो आप अपना आइटम सुरक्षित करने के लिए ऑर्डर दे सकते हैं।	wo Apa apanA Aitama surakRiwa karane ke lie OYrdara xe sakawe hEM.	So you can order to secure your item.
Ecommerce_FAQ_130	उत्पाद उपलब्ध होने पर भेज दिया जाएगा।	uwpAxa upalabXa hone para Beja xiyA jAegA.	The product will be sent when available.
Ecommerce_FAQ_131a	यदि किसी उत्पाद को बंडल या सेट के हिस्से के रूप में खरीदा गया था ।	yaxi kisI uwpAxa ko baMdala yA seta ke hisse ke rUpa meM KarIxA gayA WA .	If a product was purchased as part of the bundle or set.
Ecommerce_FAQ_131b	तो वापसी नीति भिन्न हो सकती है।	wo vApasI nIwi Binna ho sakawI hE.	So the return policy may vary.
Ecommerce_FAQ_132	कृपया विशिष्ट नियम और शर्तों को देखें या आगे के मार्गदर्शन के लिए हमारी ग्राहक सहायता टीम से संपर्क करें।	kqpayA viSiRta niyama Ora SarwoM ko xeKeM yA Age ke mArgaxarSana ke lie hamArI grAhaka sahAyawA tIma se saMparka kareM.	Please look at the specific terms and conditions or contact our customer aid team for further guidance.
Ecommerce_FAQ_133	हमारा उद्देश्य जब भी संभव हो लोकप्रिय उत्पादों को फिर से स्टॉक करना है।	hamArA uxxeSya jaba BI saMBava ho lokapriya uwpAxoM ko Pira se stOYka karanA hE.	Our aim is to re -stock popular products whenever possible.
Ecommerce_FAQ_134a	कृपया उत्पाद सूचनाओं के लिए साइन अप करें ।	kqpayA uwpAxa sUcanAoM ke lie sAina apa kareM .	Please sign up for product information.
Ecommerce_FAQ_134b	ताकि जब आइटम फिर से उपलब्ध हो तो आपको सूचित किया जा सके।	wAki jaba Aitama Pira se upalabXa ho wo Apako sUciwa kiyA jA sake.	So that when the items are available again, you can be informed.
Ecommerce_FAQ_135a	कोई उत्पाद 'जल्द ही आ रहा है' के रूप में सूचीबद्ध है ।	koI uwpAxa 'jalxa hI A rahA hE' ke rUpa meM sUcIbaxXa hE .	A product is listed as 'coming soon'.
Ecommerce_FAQ_135b	और वह प्री-ऑर्डर के लिए उपलब्ध है ।	Ora vaha prI-OYrdara ke lie upalabXa hE .	And it is available for pre-order.
Ecommerce_FAQ_135c	तो आप अपने आइटम को उपलब्ध होने से पहले सुरक्षित करने के लिए ऑर्डर दे सकते हैं।	wo Apa apane Aitama ko upalabXa hone se pahale surakRiwa karane ke lie OYrdara xe sakawe hEM.	So you can order to secure your items before it becomes available.
Ecommerce_FAQ_136a	आपका उत्पाद शिपिंग के दौरान गलत तरीके से हैंडल किए जाने के कारण क्षतिग्रस्त हो गया था ।	ApakA uwpAxa SipiMga ke xOrAna galawa warIke se hEMdala kie jAne ke kAraNa kRawigraswa ho gayA WA .	Your product was damaged due to wrong handle during shipping.
Ecommerce_FAQ_136b	तो कृपया तुरंत हमारी ग्राहक सहायता टीम से संपर्क करें।	wo kqpayA wuraMwa hamArI grAhaka sahAyawA tIma se saMparka kareM.	So please contact our customer aid team immediately.
Ecommerce_FAQ_137	हम वापसी और प्रतिस्थापन के लिए आवश्यक चरणों में आपकी सहायता करेंगे।	hama vApasI Ora prawisWApana ke lie AvaSyaka caraNoM meM ApakI sahAyawA kareMge.	We will help you in the stages required for return and replacement.
Ecommerce_FAQ_138	हम आउट-ऑफ-स्टॉक उत्पादों के लिए आरक्षण प्रदान नहीं करते हैं।	hama Auta-OYPa-stOYka uwpAxoM ke lie ArakRaNa praxAna nahIM karawe hEM.	We do not provide reservation for out-of-stock products.
Ecommerce_FAQ_139a	हालाँकि, आप उत्पाद सूचनाओं के लिए साइन अप कर सकते हैं ।	hAlAzki, Apa uwpAxa sUcanAoM ke lie sAina apa kara sakawe hEM .	However, you can sign up for product information.
Ecommerce_FAQ_139b	ताकि आइटम के फिर से उपलब्ध होने पर आपको सूचित किया जा सके।	wAki Aitama ke Pira se upalabXa hone para Apako sUciwa kiyA jA sake.	So that you can be informed when the item is re -available.
Ecommerce_FAQ_140a	कोई उत्पाद 'प्री-ऑर्डर' के रूप में सूचीबद्ध है ।	koI uwpAxa 'prI-OYrdara' ke rUpa meM sUcIbaxXa hE .	An product is listed as 'pre-order'.
Ecommerce_FAQ_140b	और कोई बैकऑर्डर के लिए उपलब्ध है ।	Ora koI bEkaOYrdara ke lie upalabXa hE .	And someone is available for back order.
Ecommerce_FAQ_140c	तो आप अपना आइटम सुरक्षित करने के लिए ऑर्डर दे सकते हैं।	wo Apa apanA Aitama surakRiwa karane ke lie OYrdara xe sakawe hEM.	So you can order to secure your item.
Ecommerce_FAQ_141	उत्पाद उपलब्ध होने पर भेज दिया जाएगा।	uwpAxa upalabXa hone para Beja xiyA jAegA.	The product will be sent when available.
Ecommerce_FAQ_142	हाँ, आप स्टोर क्रेडिट से खरीदे गए उत्पाद को वापस कर सकते हैं।	hAz, Apa stora kredita se KarIxe gae uwpAxa ko vApasa kara sakawe hEM.	Yes, you can return the product purchased from Store Credit.
Ecommerce_FAQ_143	रिफ़ंड स्टोर क्रेडिट के रूप में जारी किया जाएगा, जिसका उपयोग आप भविष्य की खरीदारी के लिए कर सकते हैं।	riPZMda stora kredita ke rUpa meM jArI kiyA jAegA, jisakA upayoga Apa BaviRya kI KarIxArI ke lie kara sakawe hEM.	The refund will be released as store credit, which you can use for future shopping.
Ecommerce_FAQ_144	हम जब भी संभव हो लोकप्रिय उत्पादों को फिर से स्टॉक करने का प्रयास करते हैं।	hama jaba BI saMBava ho lokapriya uwpAxoM ko Pira se stOYka karane kA prayAsa karawe hEM.	We try to re -stock popular products whenever possible.
Ecommerce_FAQ_145a	कृपया उत्पाद सूचनाओं के लिए साइन अप करें ।	kqpayA uwpAxa sUcanAoM ke lie sAina apa kareM .	Please sign up for product information.
Ecommerce_FAQ_145b	ताकि जब आइटम फिर से उपलब्ध हो तो आपको सूचित किया जा सके।	wAki jaba Aitama Pira se upalabXa ho wo Apako sUciwa kiyA jA sake.	So that when the items are available again, you can be informed.
Ecommerce_FAQ_146a	कोई उत्पाद 'बिक चुका है' के रूप में सूचीबद्ध है ।	koI uwpAxa 'bika cukA hE' ke rUpa meM sUcIbaxXa hE .	Any product is listed as 'sold'.
Ecommerce_FAQ_146b	लेकिन वह प्री-ऑर्डर के लिए उपलब्ध है ।	lekina vaha prI-OYrdara ke lie upalabXa hE .	But it is available for pre-order.
Ecommerce_FAQ_146c	तो आप अपना आइटम सुरक्षित करने के लिए ऑर्डर दे सकते हैं।	wo Apa apanA Aitama surakRiwa karane ke lie OYrdara xe sakawe hEM.	So you can order to secure your item.
Ecommerce_FAQ_147	उत्पाद उपलब्ध होने पर भेज दिया जाएगा।	uwpAxa upalabXa hone para Beja xiyA jAegA.	The product will be sent when available.
Ecommerce_FAQ_148	हाँ, आप प्रचारात्मक उपहार कार्ड से खरीदे गए उत्पाद को वापस कर सकते हैं।	hAz, Apa pracArAwmaka upahAra kArda se KarIxe gae uwpAxa ko vApasa kara sakawe hEM.	Yes, you can return the product purchased from the promotional gift card.
Ecommerce_FAQ_149	रिफ़ंड स्टोर क्रेडिट या नए उपहार कार्ड के रूप में जारी किया जाएगा।	riPZMda stora kredita yA nae upahAra kArda ke rUpa meM jArI kiyA jAegA.	Refund will be issued as store credit or new gift cards.
Ecommerce_FAQ_150a	कोई उत्पाद आपके पसंदीदा रंग में उपलब्ध नहीं है ।	koI uwpAxa Apake pasaMxIxA raMga meM upalabXa nahIM hE .	No product is available in your favorite color.
Ecommerce_FAQ_150b	तो वह अस्थायी रूप से स्टॉक से बाहर हो सकता है।	wo vaha asWAyI rUpa se stOYka se bAhara ho sakawA hE.	So he can temporarily be out of stock.
Ecommerce_FAQ_151a	कृपया बाद में फिर से जाँच करें ।	kqpayA bAxa meM Pira se jAzca kareM .	Please check again later.
Ecommerce_FAQ_151b	या रंग सूचनाओं के लिए साइन अप करें।	yA raMga sUcanAoM ke lie sAina apa kareM.	Or sign up for color information.
Ecommerce_FAQ_152a	कोई उत्पाद 'जल्द ही आ रहा है' के रूप में सूचीबद्ध है ।	koI uwpAxa 'jalxa hI A rahA hE' ke rUpa meM sUcIbaxXa hE .	A product is listed as 'coming soon'.
Ecommerce_FAQ_152b	लेकिन वह प्री-ऑर्डर के लिए उपलब्ध नहीं है ।	lekina vaha prI-OYrdara ke lie upalabXa nahIM hE .	But it is not available for pre-order.
Ecommerce_FAQ_152c	तो आपको तब तक प्रतीक्षा करनी होगी ।	wo Apako waba waka prawIkRA karanI hogI .	So you have to wait till then.
Ecommerce_FAQ_152d	जब तक कि वह आधिकारिक रूप से जारी न हो जाए ।	jaba waka ki vaha AXikArika rUpa se jArI na ho jAe .	Until it is officially released.
Ecommerce_FAQ_152e	और वह खरीद के लिए उपलब्ध न हो जाए।	Ora vaha KarIxa ke lie upalabXa na ho jAe.	And it should not be available for purchase.
Ecommerce_FAQ_153	हाँ, आप किसी प्रचार कार्यक्रम के दौरान खरीदे गए उत्पाद को वापस कर सकते हैं।	hAz, Apa kisI pracAra kAryakrama ke xOrAna KarIxe gae uwpAxa ko vApasa kara sakawe hEM.	Yes, you can return the product purchased during a promotional program.
Ecommerce_FAQ_154	किसी भी लागू छूट के बाद भुगतान की गई राशि के आधार पर रिफ़ंड संसाधित किया जाएगा।	kisI BI lAgU CUta ke bAxa BugawAna kI gaI rASi ke AXAra para riPZMda saMsAXiwa kiyA jAegA.	The refund will be processed based on the amount paid after any applicable exemption.
